NO ./xpm/east.xpm
SO ./xpm/north.xpm
WE ./xpm/west.xpm

F 55,100,5
C 25,48,0
EA ./xpm/south.xpm


111111111111
110010011101
11101001101
110110W001111
111111011101
11111111111
1
111111111111
11010011101
110010011101
1111111101111
111111111101
11111111111