NO ./xpm/east.xpm
SO ./xpm/north.xpm
WE ./xpm/west.xpm

F 55,100,5
C 25,48,0,11
EA ./xpm/south.xpm

11111
10N01
1111