NO ./xpm/tt.xpm
SO ./xpm/north.xpm
WE ./xpm/west.xpm
EA ./xpm/south.xpm

F 225,100,0
C 225,30,0

21111111111111111111111111
1000000000110000000000001
101W000001110N00000000001
1001000000000000000000001
11111111011000001110000000000001
100000000011000001110111111111111
11110111111111011100000010001
11110111111111011101010010001
11000000110101011100000010001
10000000000000001100000E10001
1000000S000000001101010010001
11000001110101011111011110N0111
1111011120110101 101111010001
111111111111111 111111111111
