NO ./xpm/butterfly.xpm
SO ./xpm/heart.xpm
WE ./xpm/love.xpm
EA ./xpm/paws.xpm

F 160,160,160
C 224,224,224

           1111111111111111111111111
           1000000000110000000000001
           1011000001110000000000001
           1001000000000000000000001
111111111111000000000011111111111111
100000000000000010000001
101000000000000000000001
101000000000000000000001
101000000000000010000001
101000011111111111011111
101000010100010110001111
101000010000000110000001
10100000000N000000001111
101000010000000110000001
100000010000000110001111
100000011110111111111111
111111111110111111111111
100000000000000000000001
111111011110111111111111
111111011110111111111111
100000000110110000010001
100000000000110010010001
100000000110110000011011
101010000110000010000001
100100000110110000011011
101010000110110010010001
100000000110110000010001
111111111111111111111111