NO xpm/north.xpm
SO xpm/south.xpm
WE xpm/west.xpm
EA xpm/east.xpm

F 220,100,0
C 225,30,0
1111111111111111111111111
1000000000110000000000001
1011000001110000000000001
100100000000000000000000111111111
1111111111111111001110000000000001
100001         101110111111111111
111101         11100000010001
111101         11101010010001
110001         11100000010001
100001         11100000010001
100000111111111101101010010001
11000001110101011111011110N0111
11110111 1110101 101111010001 
11111111 1111111 111111111111