NO ./mandatory/xpm/butterfly.xpm
SO ./mandatory/xpm/heart.xpm
WE ./mandatory/xpm/love.xpm
EA ./mandatory/xpm/paws.xpm

F 100,100,100
C 224,224,224

           1111111111111111111111111
           1000000000110000000000001
           1011000001110000000000001
           1001000000000000000000001
111111111111000000000011111111111111
100000000000000000000000000000000001
100000000000000000000000000000000001
100000000000000101000000000000000001
100000000000000000000000000000000001
100000000000000000000000000000000001
100000100000101000000000000100001111
100000000000000000000000000000000001
100000100000000000000000000100001111
100000000000000000000000000000000001
1000000000000N0000000000000000001111
100000000000000000000000000000000001
100000000000001010000000000000000001
100000000000000000000000000000000001
111111011110111111111111111111111111
111111111111111111111111