NO ./bonus/xpm/butterfly.xpm
SO ./bonus/xpm/heart.xpm
WE ./bonus/xpm/love.xpm
EA ./bonus/xpm/paws.xpm
D  ./bonus/xpm/door.xpm

F 100,100,100
C 224,224,224

           1111111111111111111111111
           1000000000110000000000001
           1011000001110000000000001
           1001000000000000000000001
111111111111000000000011111111111111
100000000000000000000000000000000001
100000000000000000000000000000000001
100000000100000000000000000000000001
100000000100000000000000000000000001
100000000100000000000000000000000001
100000100100000000000000000100001111
100000D00100000000000000000D00000001
100000100100000000000000000100001111
100000000100000000000011111100000001
1000000001000N0000000000000000001111
100000000000000000000000000000000001
100000000000001D10000000000000000001
100000000000000000000000000000000001
111111011110111111111111111111111111
111111111111111111111111